17,11
300,300
0,0.39,0.78
0,0.78,0
1,1,1,1,1,1,1,1,1,1,1,1,1,1,1,1,1
1,0,0,0,0,0,1,0,1,1,1,1,0,0,0,0,1
1,0,0,0,0,0,1,0,1,1,1,1,0,0,0,0,1
1,0,0,0,0,0,3,0,1,1,1,1,0,0,0,0,1
1,0,5,0,0,0,3,0,1,1,1,1,0,0,0,0,1
1,0,0,0,0,0,1,0,1,1,1,1,0,0,0,0,5
1,4,0,0,0,0,1,0,0,0,0,0,0,0,0,0,1
1,1,1,0,1,1,1,1,1,1,1,1,0,0,0,0,1
1,0,0,0,0,0,0,0,1,1,1,1,0,0,0,0,1
1,2,2,2,2,2,2,2,1,1,1,1,1,1,1,1,1